9 9 9 9 9 9 9 9 9 9 9 9 9 9 9 9 9 9 9 9 9 9 9 9 9 9 9 9 9 10 9 9 9 9 9 9 9 9 9 9 9 9 9 9 9 9 9 9 9 9
9 5 1 1 1 1 1 1 1 1 1 1 1 1 1 1 1 1 1 1 1 1 1 1 1 1 1 1 1 1 1 1 1 1 1 1 1 1 1 1 1 1 1 1 1 1 1 1 6 9
9 4 0 0 0 0 0 0 0 0 0 0 0 0 30 0 0 0 0 0 0 29 0 0 0 0 0 0 0 0 0 0 0 0 0 0 0 0 0 0 0 0 0 0 0 0 0 0 2 9
9 4 0 0 0 0 0 0 0 0 0 29 20 16 16 21 30 0 0 0 29 0 0 0 0 0 0 0 0 0 0 0 0 0 0 0 0 30 20 16 16 16 16 16 16 16 16 21 2 9
9 4 0 0 0 0 0 29 0 0 0 0 19 15 15 17 20 16 16 16 16 16 16 21 0 0 0 29 0 0 0 0 0 0 0 0 0 0 19 15 15 15 15 15 15 15 15 17 2 9
9 4 30 0 0 0 0 20 16 16 16 16 27 15 15 17 19 15 15 15 15 15 15 17 31 20 16 16 21 0 0 0 0 0 0 0 0 0 22 18 18 18 18 18 18 25 15 17 2 9
9 4 20 27 15 17 0 19 15 15 15 15 15 15 24 23 22 18 18 18 18 25 15 17 32 19 15 15 17 0 20 27 15 26 21 0 28 0 0 0 0 0 0 0 0 19 15 17 2 9
9 4 19 15 15 17 0 22 18 18 18 25 15 24 23 0 0 0 0 0 28 19 15 26 16 27 15 15 17 0 19 15 15 15 17 0 0 28 0 0 0 0 0 0 0 19 15 17 2 9
9 4 19 15 15 17 0 0 0 0 30 19 15 17 28 0 0 0 0 0 28 19 15 15 15 15 15 15 17 31 19 15 15 15 17 0 28 0 28 0 0 0 0 0 0 19 15 17 2 9
9 4 19 15 24 23 0 0 0 0 20 27 15 17 28 0 0 0 0 0 28 19 15 15 15 15 15 15 17 32 19 15 15 15 17 28 0 28 0 0 0 0 0 0 0 19 15 17 2 9
9 4 19 15 26 16 27 15 26 16 27 15 15 17 28 0 0 0 0 0 0 19 15 15 15 15 15 24 23 0 19 15 15 15 26 16 16 16 16 16 16 27 15 26 16 27 15 17 2 9
9 4 19 15 15 15 15 15 15 15 15 15 24 23 20 16 27 15 26 16 16 27 15 15 24 18 18 23 30 0 19 15 15 15 15 15 15 15 15 15 15 15 15 15 15 15 15 17 2 9
9 4 22 18 18 18 18 18 18 25 15 15 17 29 19 15 15 15 15 15 15 15 15 15 26 16 16 16 16 16 27 15 15 15 15 15 15 15 15 15 15 15 15 15 15 24 18 23 2 9
9 4 0 0 0 0 0 0 29 19 15 15 26 16 27 15 24 18 18 18 18 25 15 15 15 15 15 15 15 15 15 15 15 15 15 15 15 15 15 15 24 18 18 18 18 23 29 0 2 9
9 4 0 0 0 0 0 0 0 22 25 15 15 15 15 15 17 0 11 03 12 19 15 15 15 15 15 15 15 15 15 15 15 15 15 15 15 15 15 15 26 16 16 16 16 16 16 21 2 9
9 4 0 0 0 0 0 31 0 31 19 15 15 15 15 24 23 30 2 9 4 19 15 15 24 18 18 18 18 18 18 18 18 25 15 15 15 15 15 15 15 15 15 15 15 15 15 17 2 9
9 4 0 0 0 0 0 32 0 32 22 18 25 15 15 17 11 3 8 9 4 19 15 15 17 0 0 0 0 0 0 0 0 19 15 15 24 18 18 18 18 25 15 15 15 15 15 17 2 9
9 4 20 27 15 26 16 16 16 16 16 16 27 15 15 17 13 1 1 1 14 19 15 15 17 31 0 0 0 0 0 0 29 19 15 15 17 0 0 0 0 22 25 15 15 15 15 17 2 10
9 4 19 15 15 15 15 15 15 15 15 15 15 15 15 26 16 16 16 16 16 27 15 24 23 32 0 0 0 0 0 0 29 19 15 15 17 0 0 0 0 0 22 18 18 25 15 17 2 9
9 4 19 15 15 24 18 18 25 15 24 18 18 25 15 15 15 15 15 15 15 15 15 17 31 0 0 0 0 0 0 29 0 19 15 15 17 0 0 0 0 0 30 0 0 19 15 17 2 9
9 4 22 18 18 23 30 0 19 15 17 0 29 22 18 18 18 18 18 18 18 18 18 23 32 20 16 27 15 26 16 16 16 27 15 15 17 0 0 0 0 0 0 0 30 19 15 17 2 9
10 4 20 16 16 16 16 16 27 15 26 16 16 16 16 16 16 16 16 16 16 16 16 16 21 19 15 15 15 15 15 15 15 15 15 15 26 16 27 15 26 16 16 16 16 27 15 17 2 9
9 4 19 15 15 15 15 15 15 15 15 15 15 15 15 15 15 15 15 15 15 15 15 15 17 22 18 18 18 18 25 15 15 15 15 15 15 15 15 15 15 15 15 15 15 15 15 17 2 9
9 4 19 15 15 15 15 15 15 15 15 15 15 15 15 15 15 15 15 15 15 15 15 15 17 28 0 0 28 28 19 15 24 18 18 18 18 25 15 15 15 15 15 15 15 15 15 17 2 9
9 4 19 15 15 15 15 15 15 15 15 15 15 15 15 15 15 15 15 15 15 15 15 15 17 0 0 0 0 20 27 15 17 11 3 3 12 19 15 24 18 18 18 18 18 18 18 23 2 9
9 4 19 15 15 15 15 15 15 15 15 15 15 15 15 15 15 15 15 15 15 15 15 15 17 0 0 0 0 19 15 15 17 2 9 9 4 19 15 17 0 0 0 0 0 0 0 0 2 9
9 4 19 15 15 15 15 15 15 15 15 15 15 15 15 15 15 15 15 15 15 15 15 15 17 0 0 0 0 19 15 24 23 2 9 10 4 19 15 17 0 0 0 0 0 0 0 0 2 9
9 4 19 15 15 15 15 15 15 15 15 15 15 15 15 15 15 15 15 15 15 15 15 15 17 0 19 15 26 27 15 17 11 8 9 5 14 19 15 17 0 31 0 0 0 0 0 0 2 9
9 4 19 15 15 15 15 15 15 15 15 15 15 15 15 15 15 15 15 15 15 15 15 15 17 0 19 15 15 15 15 17 2 9 5 14 0 19 15 17 0 32 0 0 0 0 0 0 2 9
9 4 19 15 15 15 15 15 15 15 15 15 15 15 15 15 15 15 15 15 15 15 15 15 17 30 19 15 24 18 18 23 2 9 4 0 0 19 15 26 21 0 0 19 15 26 21 0 2 9
9 4 19 15 15 15 15 15 15 15 15 15 15 15 15 15 15 15 15 15 15 15 15 15 17 0 19 15 17 11 3 3 8 9 4 0 31 19 15 15 26 21 0 19 15 15 17 28 2 9
9 4 19 15 15 15 15 15 15 15 15 15 15 15 15 15 15 15 15 15 15 15 15 15 17 30 19 15 17 2 9 10 9 9 4 0 32 19 15 15 15 17 29 19 15 15 17 0 2 9
9 4 19 15 15 15 15 15 15 15 15 15 15 15 15 15 15 15 15 15 15 15 15 15 17 20 27 15 17 2 9 5 1 1 14 0 0 22 25 15 15 26 16 27 15 24 23 28 2 9
9 4 22 18 18 18 18 18 18 18 18 18 18 18 18 18 18 25 15 24 18 18 18 18 23 19 15 15 17 2 9 4 28 0 0 0 0 0 19 15 15 15 15 15 15 26 16 21 2 9
9 4 0 0 0 0 0 0 0 0 0 0 0 0 0 0 29 19 15 26 16 16 16 16 16 27 15 24 23 2 9 4 0 0 0 0 0 0 22 18 18 25 15 15 15 15 15 17 2 9
9 4 0 0 0 0 0 0 0 0 0 0 0 0 0 0 0 19 15 15 15 15 15 15 15 15 15 17 11 8 9 4 0 0 0 0 0 0 0 0 29 22 18 25 15 15 15 17 2 9
9 4 0 31 0 0 0 0 0 31 0 0 0 0 0 31 20 27 15 15 24 18 18 18 18 18 18 23 2 9 5 14 0 0 0 0 0 0 30 0 0 0 0 19 15 15 15 17 2 9
9 4 0 32 0 0 0 0 0 32 0 0 0 0 0 32 19 15 15 15 17 11 3 3 3 3 3 3 8 9 4 28 20 27 15 26 16 21 0 0 0 0 0 22 18 25 15 17 2 9
9 4 0 0 0 0 0 0 0 0 0 0 0 0 0 20 27 15 15 15 17 2 9 9 9 9 9 9 5 1 14 0 19 15 15 15 15 17 0 0 0 0 0 0 29 19 15 17 2 9
9 4 20 16 16 27 15 26 16 16 16 27 15 26 16 27 15 15 15 24 23 2 9 9 9 9 9 9 4 0 0 0 19 15 24 25 15 17 0 0 0 0 0 0 29 19 15 17 2 9
9 4 19 15 15 15 15 15 15 15 15 15 15 15 15 15 15 24 18 23 11 8 9 9 9 9 10 9 4 0 29 0 19 15 17 22 18 23 0 0 0 0 0 0 0 19 15 17 2 9
9 4 19 15 15 24 18 18 18 18 18 18 18 18 25 15 15 17 11 3 8 9 5 1 1 1 1 1 14 0 0 29 19 15 17 0 0 30 20 27 15 26 21 0 0 19 15 17 2 9
9 4 19 15 15 17 0 0 29 0 0 0 0 0 19 15 24 23 13 1 1 1 14 20 16 16 16 16 16 16 16 16 27 15 17 30 0 0 19 15 15 15 17 28 20 27 15 17 2 9
9 4 19 15 15 17 29 0 0 0 0 0 0 0 19 15 26 16 16 16 16 16 16 27 15 15 15 15 15 15 15 15 15 15 26 16 16 16 27 15 15 15 17 20 27 15 15 17 2 9
9 4 19 15 15 26 16 21 30 0 0 0 0 0 19 15 15 15 15 15 15 15 15 15 15 15 15 15 15 15 15 15 15 15 15 15 15 15 15 15 15 15 26 27 15 15 15 17 2 9
10 4 19 15 15 15 15 26 16 16 27 15 26 16 27 15 15 15 15 15 15 15 15 15 24 18 18 18 18 18 18 18 18 18 18 18 18 18 18 25 15 15 15 15 15 15 15 17 2 9
9 4 19 15 15 15 15 15 15 15 15 15 15 15 15 15 24 18 18 18 18 18 18 18 23 0 30 30 0 0 0 0 0 29 0 0 0 0 0 22 18 18 18 18 18 18 18 23 2 9
9 4 22 18 18 18 18 18 18 18 18 18 18 18 18 18 23 0 0 0 0 0 0 0 0 0 0 0 0 0 0 0 0 0 0 0 0 0 0 0 0 0 0 0 0 0 0 0 2 9
9 7 3 3 3 3 3 3 3 3 3 3 3 3 3 3 3 3 3 3 3 3 3 3 3 3 3 3 3 3 3 3 3 3 3 3 3 3 3 3 3 3 3 3 3 3 3 3 8 9
9 9 9 9 9 9 9 9 9 9 9 9 9 9 9 9 9 9 9 9 9 9 9 10 9 9 9 9 9 9 9 9 9 9 9 9 9 9 9 9 9 9 9 9 9 9 9 9 9 9

